(2,0) (2,3) (7,3) (7,1) (13,1) (13,4) (9,4) (9,7) (6,7) (2,5) (2,8)
0020000000000000
0010000111111100
0010000100000100
0011111100000100
0000000001111100
0011111001000000
0010001001000000
0010001111000000
0030000000000000